51 51 51 124 124 124 124 51 51 51 51 51 51 51 51 51 51 51 51 51 51 51 51 51 51 51 51 51 51 51 51 51 51 51 51 51 51 51 51 51 51 51 51 51 51 51 51 51 51 51 
51 51 51 124 107 107 124 51 51 51 51 51 51 51 51 51 51 51 51 51 51 51 51 51 51 51 51 51 51 51 51 51 51 51 51 51 51 51 51 51 51 51 51 51 51 51 51 51 51 51 
51 51 51 120 107 107 120 51 51 51 51 51 51 51 51 51 51 51 51 51 51 51 51 51 51 51 51 51 51 51 51 51 51 120 120 120 124 120 120 120 51 51 51 51 51 51 51 51 51 51 
51 51 51 120 107 107 120 51 51 51 51 51 51 51 51 51 51 51 51 124 124 120 120 120 120 124 124 120 120 120 124 120 120 120 115 113 113 113 114 120 120 120 51 51 51 51 51 51 51 51 
51 51 51 120 107 107 120 51 51 51 51 51 51 51 51 51 51 51 124 124 115 110 110 109 108 109 109 108 108 108 108 108 108 108 107 107 107 107 107 113 114 120 120 120 51 51 51 51 51 51 
51 51 51 120 120 120 120 51 51 51 51 51 51 51 51 51 51 51 124 115 107 107 107 107 107 107 107 107 107 107 107 107 107 107 107 107 107 107 107 107 107 113 114 120 120 51 51 51 51 51 
51 51 51 51 51 51 51 51 51 51 51 51 51 51 51 51 51 124 124 116 107 107 107 107 107 107 107 107 107 107 107 107 107 107 107 107 107 107 107 107 107 107 107 114 120 51 51 51 51 51 
51 51 51 51 51 51 51 51 51 51 51 51 51 51 51 51 124 124 115 107 107 107 107 107 107 107 107 107 107 107 107 107 107 107 107 107 107 107 107 107 107 107 107 111 120 51 51 51 51 51 
51 51 51 51 51 51 51 51 51 51 51 51 51 51 51 51 120 115 107 107 107 107 107 107 107 107 107 107 107 107 107 107 107 107 107 107 107 107 107 107 107 107 107 111 120 51 51 51 51 51 
51 51 51 51 51 51 51 51 51 51 51 51 51 51 120 120 120 116 107 107 107 107 107 107 107 107 107 107 107 107 107 107 167 166 165 107 107 107 107 107 107 107 107 111 123 51 51 51 51 51 
51 51 51 51 51 51 51 51 51 51 51 51 124 120 120 115 110 107 107 107 107 107 107 107 107 107 107 107 107 107 107 107 164 163 162 107 107 107 107 107 107 107 107 168 123 51 51 51 51 51 
51 51 51 51 51 51 51 51 51 51 51 51 120 115 110 107 107 107 107 107 107 107 107 107 107 107 107 107 107 107 107 107 161 160 159 107 107 107 107 107 170 168 120 120 123 51 51 51 51 51 
51 51 51 51 51 51 51 51 51 51 51 51 120 116 107 107 107 107 107 107 107 107 107 107 107 107 107 107 107 107 107 107 107 107 107 107 107 107 107 168 123 120 120 51 51 51 51 51 51 51 
51 51 51 51 51 51 51 51 51 51 120 120 120 116 107 107 107 170 170 170 170 170 107 107 107 107 107 107 107 107 107 107 107 107 107 107 107 107 168 120 120 51 51 51 51 51 51 51 51 51 
51 51 51 51 51 51 51 51 120 120 120 115 110 107 107 107 111 120 120 124 124 124 169 107 107 107 107 107 107 107 107 107 107 107 107 107 107 107 120 123 51 51 51 51 51 51 51 51 51 51 
51 51 51 51 51 51 51 120 120 115 110 107 107 107 107 170 168 120 51 51 51 124 124 124 169 170 170 170 107 107 107 107 107 107 107 107 107 168 120 51 51 51 51 51 51 51 51 51 51 51 
51 51 51 51 51 51 120 120 115 107 107 107 107 170 168 120 120 51 51 51 51 51 51 124 124 124 124 120 169 107 107 107 107 107 107 107 168 120 120 51 51 51 51 51 51 51 51 51 51 51 
51 51 51 51 51 51 120 115 107 107 107 107 111 120 120 120 51 51 51 51 51 51 51 51 51 51 51 124 124 169 170 170 170 170 170 168 123 120 51 51 51 51 51 51 51 51 51 51 51 51 
51 51 51 51 51 51 120 116 107 107 107 107 111 120 51 51 51 51 51 51 51 51 51 51 51 51 51 51 124 124 124 124 124 124 124 124 124 51 51 51 51 51 51 51 51 51 51 51 51 51 
51 51 51 51 51 51 120 116 107 107 107 107 111 120 120 120 51 51 51 51 51 51 51 51 51 51 51 51 51 51 51 51 51 51 51 51 51 51 51 51 51 51 51 51 51 125 120 120 125 120 
51 51 51 51 51 51 120 169 107 107 107 107 104 113 114 120 120 120 51 51 51 51 51 51 51 51 51 51 51 51 51 51 51 51 51 51 51 51 51 51 51 51 51 51 51 120 107 107 107 120 
51 51 51 51 51 51 120 124 169 107 107 104 104 104 104 113 114 120 120 120 51 51 51 51 51 51 51 51 51 51 51 51 51 51 51 51 51 51 51 51 51 51 51 51 51 120 107 107 107 120 
51 51 51 51 51 51 51 124 124 116 104 104 104 104 104 104 104 113 114 120 120 51 51 51 51 51 51 51 51 51 51 51 51 51 51 51 51 51 51 51 51 51 51 51 51 120 107 107 107 120 
51 51 51 51 51 51 51 51 124 116 104 104 104 104 104 104 104 104 104 114 120 120 51 51 51 51 51 51 51 51 51 51 51 51 51 51 51 51 51 51 51 51 51 51 51 125 120 125 120 120 
51 51 51 51 51 51 51 51 124 169 104 104 104 104 104 104 104 104 104 107 107 120 120 120 51 51 51 51 51 51 51 51 51 51 51 51 120 120 120 120 123 120 51 51 51 51 51 51 51 51 
51 51 51 51 51 51 51 51 124 124 116 104 104 104 104 104 104 104 104 107 107 107 107 120 51 51 51 51 51 51 51 51 120 123 120 120 120 115 109 109 114 120 120 120 51 51 51 51 51 51 
51 51 51 51 51 51 51 51 51 124 169 104 104 104 104 104 104 104 104 107 107 107 107 120 120 120 120 51 51 51 120 120 120 115 108 108 113 107 107 107 107 110 114 120 120 51 51 51 51 51 
51 51 51 51 51 51 51 51 51 124 124 169 170 170 104 104 104 104 104 107 107 107 107 107 107 107 120 120 120 120 120 115 109 107 107 107 107 107 107 107 107 107 107 114 120 51 51 51 51 51 
51 51 51 51 51 51 51 51 51 51 124 124 124 124 169 170 170 104 104 107 107 107 107 107 107 107 107 107 109 109 109 107 107 107 107 107 107 107 107 107 107 107 107 111 120 120 120 120 51 51 
51 51 51 51 51 51 51 51 51 51 51 51 51 124 124 124 124 169 170 107 107 107 107 107 107 107 107 107 107 107 107 107 107 104 104 104 107 107 107 107 107 107 107 107 109 113 114 120 120 51 
51 51 51 51 51 51 51 51 51 51 51 51 51 51 51 51 124 124 124 124 120 107 107 107 107 107 107 107 107 107 107 107 107 104 104 104 104 107 107 107 107 107 107 107 107 107 107 114 120 120 
51 51 51 51 51 51 51 51 51 51 51 51 51 51 51 51 51 51 51 51 120 120 107 107 107 107 107 107 107 107 107 107 107 104 104 104 104 107 107 107 107 107 107 107 107 107 107 107 114 120 
51 51 51 51 51 51 51 51 51 51 51 51 51 51 51 51 51 51 51 51 51 120 107 107 107 107 107 107 107 107 107 107 107 104 104 104 104 107 107 107 107 107 107 107 107 107 107 107 168 125 
125 125 125 122 120 125 125 120 120 125 125 125 120 51 51 51 51 51 51 51 51 120 107 107 107 107 107 107 107 107 107 107 107 107 104 107 107 107 107 107 107 107 107 107 107 107 107 168 120 120 
125 115 109 109 109 109 109 109 109 109 109 114 120 51 51 51 51 51 51 51 51 120 120 120 169 170 170 107 107 107 107 107 107 107 107 107 107 107 107 107 107 107 107 107 107 107 111 124 120 51 
120 116 107 107 170 170 170 170 170 107 107 111 125 51 51 51 51 51 51 51 51 51 51 120 120 120 120 169 170 170 170 170 170 170 107 107 107 107 170 170 170 170 170 170 170 170 111 124 51 51 
120 116 107 111 125 125 120 120 125 116 107 111 125 51 51 51 51 51 51 51 51 51 51 51 51 51 120 120 120 120 120 120 120 123 119 119 119 119 123 120 120 120 120 120 120 120 171 120 51 51 
120 116 107 111 125 51 51 51 125 169 107 111 120 51 51 51 51 51 51 51 51 51 51 51 51 51 51 51 51 51 51 51 51 124 119 119 119 119 134 51 51 51 51 51 51 120 171 120 120 51 
120 116 107 111 125 51 51 51 125 120 169 111 120 51 51 51 51 51 51 51 51 51 51 51 51 51 51 51 51 51 51 51 51 120 119 119 119 119 123 51 51 51 51 51 120 120 116 114 120 51 
125 116 107 111 120 51 51 51 51 120 125 171 120 51 51 51 51 51 51 51 51 51 51 51 51 51 51 51 51 51 51 51 51 123 119 119 119 119 120 51 51 51 51 51 120 169 170 168 120 51 
125 116 107 111 120 51 51 51 51 51 120 171 125 51 51 124 124 124 126 124 123 120 123 120 120 120 51 51 51 51 51 51 51 123 118 118 118 118 123 51 51 51 51 51 120 120 120 120 120 51 
146 116 107 111 125 125 122 125 120 51 125 171 123 51 51 124 115 109 108 109 108 109 110 109 114 120 120 123 120 120 51 51 51 123 118 118 118 118 123 51 51 51 51 51 51 51 51 51 51 51 
120 116 107 107 110 110 110 114 120 51 146 171 146 124 124 124 116 107 107 107 107 107 107 107 107 108 109 108 114 123 120 120 122 120 117 117 117 117 120 122 120 120 120 123 120 120 51 51 51 51 
146 116 107 107 107 107 107 111 120 51 146 169 172 172 172 113 107 107 107 107 107 107 107 107 107 107 107 107 107 110 109 108 109 109 107 107 107 107 108 108 109 110 109 110 114 120 51 51 51 51 
123 116 107 107 107 107 107 111 120 51 146 124 124 124 124 116 107 107 107 107 107 107 107 107 107 107 107 107 107 107 107 107 107 107 107 107 107 107 107 107 107 107 107 107 168 120 135 120 136 51 
146 169 170 170 170 107 107 111 120 51 51 51 51 51 124 116 107 107 107 107 107 107 107 107 107 107 107 107 107 107 107 107 107 107 107 107 107 107 107 107 107 107 107 111 123 123 115 114 135 51 
146 146 146 146 123 116 107 111 146 51 51 51 51 51 124 169 170 170 170 170 170 170 170 170 170 170 107 107 107 107 107 107 107 107 107 107 107 107 107 107 107 107 107 107 172 172 107 111 120 51 
51 51 51 51 123 116 107 111 146 51 51 51 51 51 124 125 124 124 120 120 124 124 124 124 120 124 169 170 107 107 107 107 107 107 107 107 107 107 107 107 170 170 170 168 123 123 169 168 124 51 
51 51 51 51 146 169 170 168 146 51 51 51 51 51 51 51 51 51 51 51 51 51 51 51 120 120 124 124 169 170 170 170 170 170 170 170 170 170 170 168 135 123 135 124 123 136 124 135 124 51 
51 51 51 51 146 120 120 120 146 51 51 51 51 51 51 51 51 51 51 51 51 51 51 51 51 51 51 124 124 120 120 124 124 124 124 124 120 120 120 124 123 51 51 51 51 51 51 51 51 51 
